##################
#                #
#           O    #
#     G          #
######           #
# O  #      P    #
#    #           #
#            XX  #
##################
