##################
#                ######
#           O         #
#                     #
######               #
# O  #      P    #####
#    #           #
#            XX  #
#######          #
      #          #
      ############
