##################
#                ######
# P         O         #
#                     #
######               #
# O  #           #####
#    #           #
#            XX  #
#######          #
      #          #
      ############
